16
22
3333333333333377777000
4000000000000374777000
4000000000000377733000
4004443330000377333303
4733433333443373333303
4733473777447773713303
4733113700000073113300
4733173707777073713374
4733173707777073713374
0033113700000073113374
3033173777447773743374
3033333733443333343374
3033337730000333444004
0003377730000000000004
0007774730000000000004
0007777733333333333333


0 is grass
1 is forest
2 is desert
3 is water
4 is mountain
5 is horizontal bridge
6 is vertical bridge
7 is acid