16
22
3300000020444444000000
4333000222044441000000
4023633202242441000002
4220003300222022222223
3363300300002220002363
3000333330000000003340
4000020033334400233342
4111111000030400234363
4411110040050002334423
0444000044232002334363
0100002202332010233300
0111023332320000023000
4442233233320440025200
0022332223200440023320
0002222022222040233320
0000220044333202333000


0 is grass
1 is forest
2 is desert
3 is water
4 is mountain
5 is horizontal bridge
6 is vertical bridge
7 is acid