16
22
0000000008448000000000
0000000008000000000000
0000088888008888800000
0000084078008704800000
0000080700000070800000
0000087008008007800000
8888888088778808888808
4000000007447000000004
4000000007447000000004
8088888088778808888888
0000087008008007800000
0000080700000070800000
0000084078008704800000
0000088888008888800000
0000000000008000000000
0000000008448000000000


0 is grass
1 is forest
2 is desert
3 is water
4 is mountain
5 is horizontal bridge
6 is vertical bridge
7 is acid
8 is black pit by a wall
9 is black pit you can move through
A is horizontal highway
B is vertical highway