16
22
0000000000000000222222
0000333333333300222222
0000333333333300333222
0000003330000000333222
0000000000000000330000
0000000000000000000334
0003333337777333333333
0003333337777333333333
0003333000000000000334
0003333000000000330000
0033333000333333332222
0033333222333333332222
2233333222333333332222
2222222222222333332222
2222222222222222222222
2223222222222222222222


0 is grass
1 is forest
2 is desert
3 is water
4 is mountain
5 is horizontal bridge
6 is vertical bridge
7 is acid