16
22
2222121030330122122222
2422220333333012122222
2222220333334402244222
2200021000334422022222
2000001120002200024442
2200022222222200222242
4222222444222220222422
0442224222442122224222
0002122222222224222242
4422200222222442220022
4422002222244222244422
0000022200022222044402
0000222000000221044402
0000020000000002120022
0000000000000000022222
0000000000000000000002


0 is grass
1 is forest
2 is desert
3 is water
4 is mountain
5 is horizontal bridge
6 is vertical bridge
7 is acid