16
22
3333333333333333330000
3333333333330333330000
3330000000000333330000
3300000000010133336633
3300111100010113336633
3000000000010011002043
3010000000010000002443
3440000002222222222443
3442222222222000000443
3442110000424000000103
3402331000010000000003
3366333300010011110033
3366333330000000000333
0000333333333333333333
0000333333333333333333
0000333333333333333333


0 is grass
1 is forest
2 is desert
3 is water
4 is mountain
5 is horizontal bridge
6 is vertical bridge
7 is acid
8 is black pit
A is horizontal highway
B is vertical highway