16
22
4444400000000033333222
4400000000000003333222
4000000330440003300222
0000004330000000001020
0000000300000033310000
0000000000400003300000
0004000001410000004000
0006004001410000006000
0006004001411000006000
0004004001441000004000
0000000011441004400000
0000000014440040040000
0200033000440000000000
2220333300000011000044
2220111100000133104444
2220000000440333344444


0 is grass
1 is forest
2 is desert
3 is water
4 is mountain
5 is horizontal bridge
6 is vertical bridge
7 is acid